XXXXXXXXXXXXXXXXXXXXXXXXXXXXXXXX
XOOOOOXOOOOOOXX0000000000000000X
XXOXXOXOXXXXOXX0X0XXXXXXXXXXXX0X
XXOXXOXOXXXXOXX0X0X0000000000X0X
XOOXXOOOXXXXOXX0X0X0XXXXXXXX0X0X
XOXXXXXXXXXXO000X0X0X00000XX0X0X
X0XXXXXXXXXXOXXXX0X0X0XXX0XX0X0X
X00000XXXXXXOXXXX0X0000000XX0X0X
XXXXX0XXXXXXOXXXX0XXXXXXXXXX0X0X
XXXXX0XXXXXXOXXX0000000000000X0X
XXXXX0XXXXXXXXXX0XXXXXXXXXXXXX0X
XXXXX0XXXXXXXXXX0XXXXXXXXXXXXX0X
X000000000XXXXXX00XXXXXXXXXXXX0X
X0XXXXXXX0XXXXXXX000XXXXXXXXXX0X
X0XXXXXXX000XXXXXXX0XXXXXXXXXX0X
X0XXXXXXXXX00XXXX00000XXXXXXXX0X
X00000000000000000XXX000000X000X
XXXXXXXXXXXXXXXXXXXXXXXXXXXXXXXX
XXXXXXXXXXXXXXXXXXXXXXXXXXXXXXXX